transaction_id,user_id,timestamp,amount,type,channel,location,merchant,balance_before_txn,balance_after_txn,is_fraud,rules_applied,fraud_score,time_diff_from_last,hour
20000,1001,2025-05-15 08:42:52,2901.0,Deposit,Online,"Kimberley, NC",Clicks,93125.26,96026.26,0,New Location,1,,8
20001,1001,2025-05-16 05:29:52,4984.64,Purchase,Online,"Potchefstroom, NW",Standard Bank ATM,96026.26,91041.62,0,New Location,1,74820.0,5
20002,1001,2025-05-16 09:23:52,3320.37,Purchase,POS,"Polokwane, LP",Puma Energy,91041.62,87721.25,0,New Location,1,14040.0,9
20003,1001,2025-05-17 02:50:52,2724.74,Transfer,POS,"Potchefstroom, NW",FNB ATM,87721.25,84996.51,0,Odd Hours,1,62820.0,2
20004,1001,2025-05-17 16:34:52,262.86,Withdrawal,Online,"Polokwane, LP",Woolworths,84996.51,84733.65,0,,0,49440.0,16
20005,1001,2025-05-18 12:03:52,4774.89,Purchase,App,"Polokwane, LP",Gautrain,84733.65,79958.76,0,,0,70140.0,12
20006,1002,2025-06-05 12:15:53,1082.92,Transfer,POS,"Potchefstroom, NW",Standard Bank ATM,89263.02,88180.1,0,New Location,1,,12
20007,1002,2025-06-05 18:00:53,3706.73,Withdrawal,App,"Potchefstroom, NW",Standard Bank ATM,88180.1,84473.37000000001,0,,0,20700.0,18
20008,1002,2025-06-06 10:50:53,2765.39,Transfer,Online,"Rosebank, GP",Flight Centre,84473.37000000001,81707.98000000001,0,New Location,1,60600.0,10
20009,1003,2025-05-19 02:01:29,4007.5,Deposit,Online,"Gqeberha, EC",Takealot,16718.53,20726.03,0,Odd Hours|New Location,2,,2
20010,1003,2025-05-19 22:19:29,1199.37,Fare,Online,"Umhlanga, KZN",Takealot,20726.03,19526.66,0,New Location,1,73080.0,22
20011,1003,2025-05-20 03:16:29,3300.55,Fare,App,"Mowbray, WC",Puma Energy,19526.66,16226.11,0,Odd Hours|New Location,2,17820.0,3
20012,1003,2025-05-21 00:56:29,4716.84,Withdrawal,App,"Polokwane, LP",Game,16226.11,11509.27,0,Odd Hours|New Location,2,78000.0,0
20013,1003,2025-05-21 08:28:29,4694.63,Purchase,Online,"Kimberley, NC",FNB ATM,11509.27,6814.64,0,New Location,1,27120.0,8
20014,1004,2025-06-19 02:08:26,4450.32,Purchase,App,"Rosebank, GP",FNB ATM,96746.6,92296.28,0,Odd Hours|New Location,2,,2
20015,1004,2025-06-19 13:27:26,1366.55,Withdrawal,POS,"Mowbray, WC",Shoprite,92296.28,90929.73,0,New Location,1,40740.0,13
20016,1004,2025-06-20 07:54:26,3773.84,Deposit,Online,"Rosebank, GP",Puma Energy,90929.73,94703.57,0,,0,66420.0,7
20017,1004,2025-06-20 10:50:26,1548.54,Transfer,App,"Mowbray, WC",Shoprite,94703.57,93155.03,0,,0,10560.0,10
20018,1004,2025-06-20 14:10:26,3647.25,Deposit,POS,"Polokwane, LP",Flight Centre,93155.03,96802.28,0,New Location,1,12000.0,14
20019,1004,2025-06-21 11:07:26,2809.27,Purchase,POS,"Polokwane, LP",Standard Bank ATM,96802.28,93993.01,0,,0,75420.0,11
20020,1004,2025-06-21 11:42:26,4911.25,Purchase,ATM,"Mowbray, WC",FNB ATM,93993.01,89081.76,0,,0,2100.0,11
20021,1005,2025-06-05 12:18:50,2376.02,Withdrawal,App,"Mbombela, MP",KFC,68968.23,66592.20999999999,0,New Location,1,,12
20022,1005,2025-06-06 11:41:50,253.06,Fare,Online,"Mbombela, MP",FNB ATM,66592.20999999999,66339.15,0,,0,84180.0,11
20023,1005,2025-06-06 13:57:50,1494.34,Withdrawal,App,"Polokwane, LP",Standard Bank ATM,66339.15,64844.81,0,New Location,1,8160.0,13
20024,1005,2025-06-07 11:44:50,1151.08,Purchase,ATM,"Kimberley, NC",KFC,64844.81,63693.73,0,New Location,1,78420.0,11
20025,1005,2025-06-08 11:13:50,2656.17,Purchase,ATM,"Rosebank, GP",Puma Energy,63693.73,61037.56,0,New Location,1,84540.0,11
20026,1005,2025-06-09 01:32:50,115.35,Transfer,App,"Mbombela, MP",Standard Bank ATM,61037.56,60922.21,0,Odd Hours,1,51540.0,1
20027,1005,2025-06-09 08:32:50,4455.83,Withdrawal,POS,"Umhlanga, KZN",Puma Energy,60922.21,56466.38,0,New Location,1,25200.0,8
20028,1005,2025-06-09 13:51:50,1359.76,Purchase,Online,"Mowbray, WC",Puma Energy,56466.38,55106.62,0,New Location,1,19140.0,13
20029,1005,2025-06-09 19:29:50,189.51,Fare,POS,"Umhlanga, KZN",Gautrain,55106.62,54917.10999999999,0,,0,20280.0,19
20030,1006,2025-05-21 08:13:30,4899.07,Transfer,POS,"Rosebank, GP",Gautrain,28406.28,23507.21,0,New Location,1,,8
20031,1006,2025-05-22 06:56:30,4130.71,Purchase,ATM,"Kimberley, NC",Puma Energy,23507.21,19376.5,0,New Location,1,81780.0,6
20032,1006,2025-05-22 22:56:30,3414.94,Withdrawal,POS,"Potchefstroom, NW",Standard Bank ATM,19376.5,15961.56,0,New Location,1,57600.0,22
20033,1006,2025-05-23 11:02:30,1373.07,Purchase,App,"Gqeberha, EC",Woolworths,15961.56,14588.49,0,New Location,1,43560.0,11
20034,1006,2025-05-24 00:27:30,25.3,Deposit,ATM,"Rosebank, GP",Clicks,14588.49,14613.79,0,Odd Hours,1,48300.0,0
20035,1006,2025-05-24 07:01:30,2289.81,Purchase,POS,"Mbombela, MP",Game,14613.79,12323.98,0,New Location,1,23640.0,7
20036,1006,2025-05-25 02:16:30,4292.63,Withdrawal,ATM,"Rosebank, GP",Gautrain,12323.98,8031.349999999999,0,Odd Hours,1,69300.0,2
20037,1006,2025-05-25 08:27:30,2719.03,Withdrawal,ATM,"Rosebank, GP",KFC,8031.349999999999,5312.32,0,,0,22260.0,8
20038,1006,2025-05-26 05:23:30,3280.56,Fare,POS,"Kimberley, NC",Woolworths,5312.32,2031.76,0,,0,75360.0,5
20039,1007,2025-05-14 05:48:11,4354.77,Deposit,POS,"Polokwane, LP",FNB ATM,7513.15,11867.92,0,New Location,1,,5
20040,1007,2025-05-14 14:59:11,1660.79,Withdrawal,App,"Mowbray, WC",Woolworths,11867.92,10207.13,0,New Location,1,33060.0,14
20041,1007,2025-05-14 23:26:11,3574.41,Transfer,POS,"Polokwane, LP",Flight Centre,10207.13,6632.720000000001,0,,0,30420.0,23
20042,1007,2025-05-15 21:49:11,3471.18,Deposit,ATM,"Polokwane, LP",Takealot,6632.720000000001,10103.9,0,,0,80580.0,21
20043,1007,2025-05-16 18:40:11,2013.51,Fare,App,"Potchefstroom, NW",Gautrain,10103.9,8090.390000000001,0,New Location,1,75060.0,18
20044,1007,2025-05-16 22:16:11,553.26,Fare,ATM,"Polokwane, LP",Clicks,8090.390000000001,7537.130000000001,0,,0,12960.0,22
20045,1007,2025-05-17 19:32:11,1120.01,Purchase,Online,"Mbombela, MP",Takealot,7537.130000000001,6417.120000000001,0,New Location,1,76560.0,19
20046,1007,2025-05-18 12:42:11,3034.57,Withdrawal,Online,"Gqeberha, EC",KFC,6417.120000000001,3382.5500000000006,0,New Location,1,61800.0,12
20047,1007,2025-05-18 18:59:11,3884.36,Deposit,Online,"Kimberley, NC",Gautrain,3382.5500000000006,7266.910000000001,0,New Location,1,22620.0,18
20048,1007,2025-05-19 16:16:11,1963.26,Purchase,ATM,"Gqeberha, EC",Game,7266.910000000001,5303.650000000001,0,,0,76620.0,16
20049,1008,2025-06-16 12:39:20,2033.43,Transfer,Online,"Potchefstroom, NW",Shoprite,61933.65,59900.22,0,New Location,1,,12
20050,1008,2025-06-17 03:05:20,30.02,Transfer,Online,"Potchefstroom, NW",Standard Bank ATM,59900.22,59870.2,0,Odd Hours,1,51960.0,3
20051,1008,2025-06-18 02:01:20,694.27,Deposit,ATM,"Gqeberha, EC",Standard Bank ATM,59870.2,60564.47,0,Odd Hours|New Location,2,82560.0,2
20052,1009,2025-07-01 19:14:23,681.85,Transfer,Online,"Mbombela, MP",Standard Bank ATM,15392.88,14711.03,0,New Location,1,,19
20053,1009,2025-07-02 13:06:23,1821.68,Fare,App,"Umhlanga, KZN",Game,14711.03,12889.35,0,New Location,1,64320.0,13
20054,1009,2025-07-02 17:01:23,3445.26,Purchase,App,"Potchefstroom, NW",Puma Energy,12889.35,9444.089999999998,0,New Location,1,14100.0,17
20055,1009,2025-07-03 04:58:23,4931.24,Transfer,App,"Gqeberha, EC",Gautrain,9444.089999999998,4512.849999999999,0,New Location,1,43020.0,4
20056,1009,2025-07-03 09:32:23,850.33,Withdrawal,Online,"Umhlanga, KZN",Flight Centre,4512.849999999999,3662.519999999999,0,,0,16440.0,9
20057,1010,2025-07-04 07:34:46,2280.57,Fare,App,"Mbombela, MP",Clicks,23682.26,21401.69,0,New Location,1,,7
20058,1010,2025-07-05 07:19:46,2028.11,Fare,POS,"Gqeberha, EC",Shoprite,21401.69,19373.58,0,New Location,1,85500.0,7
20059,1010,2025-07-05 12:01:46,456.7,Purchase,Online,"Umhlanga, KZN",Standard Bank ATM,19373.58,18916.88,0,New Location,1,16920.0,12
20060,1010,2025-07-05 17:03:46,2281.68,Withdrawal,Online,"Rosebank, GP",Gautrain,18916.88,16635.199999999997,0,New Location,1,18120.0,17
20061,1010,2025-07-05 23:23:46,1346.65,Purchase,App,"Mbombela, MP",Clicks,16635.199999999997,15288.549999999996,0,,0,22800.0,23
20062,1010,2025-07-06 04:55:46,3833.6,Transfer,Online,"Mowbray, WC",Woolworths,15288.549999999996,11454.949999999995,0,New Location,1,19920.0,4
20063,1010,2025-07-06 23:11:46,4247.21,Purchase,POS,"Polokwane, LP",FNB ATM,11454.949999999995,7207.739999999997,0,New Location,1,65760.0,23
20064,1010,2025-07-07 03:33:46,3563.39,Purchase,POS,"Polokwane, LP",KFC,7207.739999999997,3644.349999999997,0,Odd Hours,1,15720.0,3
20065,1010,2025-07-07 04:12:46,1149.66,Fare,App,"Gqeberha, EC",Woolworths,3644.349999999997,2494.689999999997,0,,0,2340.0,4
20066,1010,2025-07-07 23:41:46,232.51,Withdrawal,App,"Gqeberha, EC",Woolworths,2494.689999999997,2262.1799999999967,0,,0,70140.0,23
20067,1011,2025-06-11 23:02:31,716.2,Deposit,App,"Gqeberha, EC",Clicks,18651.29,19367.49,0,New Location,1,,23
20068,1011,2025-06-12 21:40:31,2138.88,Fare,Online,"Polokwane, LP",Standard Bank ATM,19367.49,17228.61,0,New Location,1,81480.0,21
20069,1011,2025-06-13 11:32:31,4790.41,Withdrawal,POS,"Rosebank, GP",Takealot,17228.61,12438.2,0,New Location,1,49920.0,11
20070,1011,2025-06-14 09:55:31,723.68,Purchase,App,"Umhlanga, KZN",Gautrain,12438.2,11714.52,0,New Location,1,80580.0,9
20071,1012,2025-06-12 10:13:57,4091.9,Withdrawal,App,"Polokwane, LP",Flight Centre,35176.66,31084.76,0,New Location,1,,10
20072,1012,2025-06-13 04:11:57,4419.09,Transfer,ATM,"Polokwane, LP",Clicks,31084.76,26665.67,0,,0,64680.0,4
20073,1012,2025-06-13 10:08:57,1046.07,Transfer,ATM,"Mbombela, MP",FNB ATM,26665.67,25619.6,0,New Location,1,21420.0,10
20074,1012,2025-06-13 17:36:57,1347.33,Withdrawal,ATM,"Rosebank, GP",Woolworths,25619.6,24272.270000000004,0,New Location,1,26880.0,17
20075,1012,2025-06-14 16:47:57,2382.67,Deposit,ATM,"Gqeberha, EC",Takealot,24272.270000000004,26654.94,0,New Location,1,83460.0,16
20076,1012,2025-06-15 05:27:57,4808.89,Withdrawal,POS,"Mbombela, MP",Woolworths,26654.94,21846.050000000003,0,,0,45600.0,5
20077,1013,2025-05-15 16:35:17,4685.22,Purchase,Online,"Rosebank, GP",Woolworths,24962.07,20276.85,0,New Location,1,,16
20078,1013,2025-05-16 11:42:17,1796.87,Fare,Online,"Kimberley, NC",Standard Bank ATM,20276.85,18479.98,0,New Location,1,68820.0,11
20079,1013,2025-05-16 21:13:17,1369.61,Fare,App,"Mowbray, WC",Takealot,18479.98,17110.37,0,New Location,1,34260.0,21
20080,1013,2025-05-17 00:48:17,3949.58,Deposit,Online,"Polokwane, LP",Woolworths,17110.37,21059.95,0,Odd Hours|New Location,2,12900.0,0
20081,1014,2025-05-26 00:45:20,4560.61,Withdrawal,Online,"Kimberley, NC",Standard Bank ATM,35956.15,31395.54,0,Odd Hours|New Location,2,,0
20082,1014,2025-05-26 05:56:20,3964.48,Fare,POS,"Mbombela, MP",FNB ATM,31395.54,27431.06,0,New Location,1,18660.0,5
20083,1014,2025-05-26 20:01:20,2285.3,Withdrawal,Online,"Potchefstroom, NW",Puma Energy,27431.06,25145.76,0,New Location,1,50700.0,20
20084,1014,2025-05-27 05:56:20,3068.25,Transfer,Online,"Mbombela, MP",KFC,25145.76,22077.51,0,,0,35700.0,5
20085,1014,2025-05-27 12:06:20,4220.73,Transfer,Online,"Gqeberha, EC",Shoprite,22077.51,17856.780000000002,0,New Location,1,22200.0,12
20086,1014,2025-05-27 22:00:20,2089.5,Purchase,App,"Kimberley, NC",Puma Energy,17856.780000000002,15767.280000000002,0,,0,35640.0,22
20087,1014,2025-05-28 10:54:20,3575.06,Purchase,Online,"Polokwane, LP",Clicks,15767.280000000002,12192.220000000005,0,New Location,1,46440.0,10
20088,1014,2025-05-28 17:18:20,2751.79,Fare,App,"Mbombela, MP",Clicks,12192.220000000005,9440.430000000004,0,,0,23040.0,17
20089,1014,2025-05-29 10:43:20,1122.53,Withdrawal,App,"Umhlanga, KZN",FNB ATM,9440.430000000004,8317.900000000003,0,New Location,1,62700.0,10
20090,1014,2025-05-29 18:28:20,4628.67,Purchase,App,"Mbombela, MP",Puma Energy,8317.900000000003,3689.230000000003,0,,0,27900.0,18
20091,1015,2025-05-23 06:34:19,3538.44,Withdrawal,ATM,"Kimberley, NC",KFC,30657.36,27118.92,0,New Location,1,,6
20092,1015,2025-05-23 18:30:19,1147.56,Purchase,App,"Mbombela, MP",KFC,27118.92,25971.36,0,New Location,1,42960.0,18
20093,1015,2025-05-24 01:15:19,1917.58,Fare,POS,"Kimberley, NC",Gautrain,25971.36,24053.78,0,Odd Hours,1,24300.0,1
20094,1015,2025-05-24 04:10:19,4899.55,Fare,App,"Mbombela, MP",Flight Centre,24053.78,19154.23,0,,0,10500.0,4
20095,1015,2025-05-25 00:24:19,4306.58,Withdrawal,App,"Polokwane, LP",Game,19154.23,14847.65,0,Odd Hours|New Location,2,72840.0,0
20096,1015,2025-05-25 23:46:19,4483.36,Deposit,ATM,"Polokwane, LP",Game,14847.65,19331.01,0,,0,84120.0,23
20097,1015,2025-05-26 04:39:19,3813.89,Transfer,POS,"Mowbray, WC",FNB ATM,19331.01,15517.12,0,New Location,1,17580.0,4
20098,1016,2025-06-12 06:09:13,3548.96,Fare,App,"Mbombela, MP",KFC,52664.96,49116.0,0,New Location,1,,6
20099,1016,2025-06-12 18:54:13,4471.97,Fare,POS,"Polokwane, LP",Woolworths,49116.0,44644.03,0,New Location,1,45900.0,18
20100,1016,2025-06-13 14:42:13,4045.34,Purchase,App,"Mbombela, MP",Takealot,44644.03,40598.69,0,,0,71280.0,14
20101,1016,2025-06-14 09:02:13,4501.87,Deposit,Online,"Kimberley, NC",Game,40598.69,45100.560000000005,0,New Location,1,66000.0,9
20102,1016,2025-06-14 23:21:13,2608.78,Purchase,POS,"Mbombela, MP",Woolworths,45100.560000000005,42491.780000000006,0,,0,51540.0,23
20103,1016,2025-06-15 16:52:13,2149.15,Transfer,App,"Umhlanga, KZN",Shoprite,42491.780000000006,40342.630000000005,0,New Location,1,63060.0,16
20104,1016,2025-06-16 07:36:13,4108.27,Withdrawal,ATM,"Rosebank, GP",Standard Bank ATM,40342.630000000005,36234.36,0,New Location,1,53040.0,7
20105,1017,2025-07-03 13:46:05,4615.71,Fare,Online,"Mowbray, WC",Game,42382.36,37766.65,0,New Location,1,,13
20106,1017,2025-07-04 12:37:05,2692.02,Purchase,POS,"Gqeberha, EC",Clicks,37766.65,35074.630000000005,0,New Location,1,82260.0,12
20107,1017,2025-07-05 09:27:05,655.51,Purchase,POS,"Rosebank, GP",Clicks,35074.630000000005,34419.12,0,New Location,1,75000.0,9
20108,1017,2025-07-06 07:07:05,1449.1,Fare,Online,"Mowbray, WC",FNB ATM,34419.12,32970.020000000004,0,,0,78000.0,7
20109,1017,2025-07-06 19:27:05,1318.29,Transfer,App,"Gqeberha, EC",Takealot,32970.020000000004,31651.730000000003,0,,0,44400.0,19
20110,1017,2025-07-07 01:43:05,1413.45,Transfer,App,"Kimberley, NC",KFC,31651.730000000003,30238.28,0,Odd Hours|New Location,2,22560.0,1
20111,1017,2025-07-07 02:35:05,669.0,Withdrawal,Online,"Umhlanga, KZN",Game,30238.28,29569.28,0,Odd Hours|New Location,2,3120.0,2
20112,1017,2025-07-07 22:57:05,2420.72,Transfer,ATM,"Mowbray, WC",Shoprite,29569.28,27148.56,0,,0,73320.0,22
20113,1017,2025-07-08 02:14:05,3255.56,Fare,Online,"Mbombela, MP",Flight Centre,27148.56,23893.0,0,Odd Hours|New Location,2,11820.0,2
20114,1017,2025-07-08 09:34:05,3784.59,Fare,POS,"Kimberley, NC",Shoprite,23893.0,20108.41,0,,0,26400.0,9
20115,1018,2025-06-11 14:07:02,2727.65,Deposit,ATM,"Mbombela, MP",Standard Bank ATM,78763.47,81491.12,0,New Location,1,,14
20116,1018,2025-06-12 04:03:02,812.17,Purchase,ATM,"Polokwane, LP",Gautrain,81491.12,80678.95,0,New Location,1,50160.0,4
20117,1018,2025-06-12 18:03:02,3495.91,Withdrawal,App,"Umhlanga, KZN",FNB ATM,80678.95,77183.04,0,New Location,1,50400.0,18
20118,1018,2025-06-12 19:59:02,4189.97,Fare,POS,"Umhlanga, KZN",Gautrain,77183.04,72993.06999999999,0,,0,6960.0,19
20119,1018,2025-06-13 16:12:02,328.66,Deposit,POS,"Mbombela, MP",Woolworths,72993.06999999999,73321.73,0,,0,72780.0,16
20120,1019,2025-06-02 22:03:14,3867.3,Transfer,App,"Rosebank, GP",Takealot,25052.76,21185.46,0,New Location,1,,22
20121,1019,2025-06-03 12:20:14,1776.54,Withdrawal,Online,"Mbombela, MP",Puma Energy,21185.46,19408.92,0,New Location,1,51420.0,12
20122,1019,2025-06-04 04:55:14,3675.42,Purchase,ATM,"Gqeberha, EC",Standard Bank ATM,19408.92,15733.499999999998,0,New Location,1,59700.0,4
20123,1020,2025-05-25 20:06:34,3094.35,Transfer,App,"Mowbray, WC",Puma Energy,85444.5,82350.15,0,New Location,1,,20
20124,1020,2025-05-26 01:54:34,2170.84,Transfer,ATM,"Polokwane, LP",Flight Centre,82350.15,80179.31,0,Odd Hours|New Location,2,20880.0,1
20125,1020,2025-05-26 08:23:34,4673.62,Purchase,Online,"Rosebank, GP",Gautrain,80179.31,75505.69,0,New Location,1,23340.0,8
20126,1020,2025-05-26 16:40:34,3238.3,Purchase,Online,"Potchefstroom, NW",FNB ATM,75505.69,72267.39,0,New Location,1,29820.0,16
20127,1020,2025-05-26 19:58:34,941.07,Withdrawal,Online,"Kimberley, NC",Game,72267.39,71326.31999999999,0,New Location,1,11880.0,19
20128,1020,2025-05-27 14:36:34,1826.95,Fare,Online,"Potchefstroom, NW",Shoprite,71326.31999999999,69499.37,0,,0,67080.0,14
20129,1021,2025-05-10 21:36:28,2967.76,Fare,Online,"Polokwane, LP",KFC,24486.51,21518.75,0,New Location,1,,21
20130,1021,2025-05-11 17:12:28,2966.28,Transfer,App,"Rosebank, GP",Shoprite,21518.75,18552.47,0,New Location,1,70560.0,17
20131,1021,2025-05-12 06:30:28,670.07,Purchase,Online,"Gqeberha, EC",FNB ATM,18552.47,17882.4,0,New Location,1,47880.0,6
20132,1021,2025-05-12 19:49:28,1563.1,Fare,ATM,"Kimberley, NC",Takealot,17882.4,16319.3,0,New Location,1,47940.0,19
20133,1021,2025-05-13 18:58:28,2489.6,Withdrawal,Online,"Gqeberha, EC",Game,16319.3,13829.7,0,,0,83340.0,18
20134,1021,2025-05-14 11:44:28,3747.37,Withdrawal,App,"Polokwane, LP",Woolworths,13829.7,10082.330000000002,0,,0,60360.0,11
20135,1021,2025-05-15 09:34:28,2555.93,Deposit,POS,"Potchefstroom, NW",FNB ATM,10082.330000000002,12638.260000000002,0,New Location,1,78600.0,9
20136,1022,2025-06-21 19:34:41,1964.9,Transfer,POS,"Polokwane, LP",Flight Centre,82285.07,80320.17000000001,0,New Location,1,,19
20137,1022,2025-06-21 21:53:41,3097.28,Fare,Online,"Polokwane, LP",Flight Centre,80320.17000000001,77222.89000000001,0,,0,8340.0,21
20138,1022,2025-06-22 07:24:41,1454.49,Withdrawal,ATM,"Kimberley, NC",Takealot,77222.89000000001,75768.40000000001,0,New Location,1,34260.0,7
20139,1022,2025-06-22 19:42:41,949.06,Withdrawal,Online,"Rosebank, GP",Flight Centre,75768.40000000001,74819.34000000001,0,New Location,1,44280.0,19
20140,1023,2025-05-19 07:01:10,920.04,Transfer,App,"Umhlanga, KZN",Standard Bank ATM,23052.18,22132.14,0,New Location,1,,7
20141,1023,2025-05-19 11:47:10,933.85,Transfer,App,"Mbombela, MP",Woolworths,22132.14,21198.29,0,New Location,1,17160.0,11
20142,1023,2025-05-19 12:53:10,1036.53,Withdrawal,ATM,"Rosebank, GP",Shoprite,21198.29,20161.76,0,New Location,1,3960.0,12
20143,1024,2025-07-07 12:00:22,3562.34,Withdrawal,Online,"Potchefstroom, NW",KFC,83835.24,80272.90000000001,0,New Location,1,,12
20144,1024,2025-07-08 11:35:22,575.74,Purchase,Online,"Polokwane, LP",Clicks,80272.90000000001,79697.16,0,New Location,1,84900.0,11
20145,1024,2025-07-08 18:03:22,3552.4,Transfer,App,"Umhlanga, KZN",FNB ATM,79697.16,76144.76000000001,0,New Location,1,23280.0,18
20146,1025,2025-06-16 01:08:29,955.59,Purchase,App,"Gqeberha, EC",Standard Bank ATM,57181.55,56225.96000000001,0,Odd Hours|New Location,2,,1
20147,1025,2025-06-16 15:06:29,2336.92,Fare,ATM,"Mbombela, MP",KFC,56225.96000000001,53889.04000000001,0,New Location,1,50280.0,15
20148,1025,2025-06-17 07:06:29,3483.93,Purchase,App,"Gqeberha, EC",Flight Centre,53889.04000000001,50405.11000000001,0,,0,57600.0,7
20149,1025,2025-06-17 18:56:29,4371.58,Fare,ATM,"Mowbray, WC",Shoprite,50405.11000000001,46033.530000000006,0,New Location,1,42600.0,18
20150,1025,2025-06-17 20:06:29,4844.34,Deposit,Online,"Mbombela, MP",FNB ATM,46033.530000000006,50877.87000000001,0,,0,4200.0,20
20151,1025,2025-06-18 13:53:29,2836.9,Deposit,POS,"Mowbray, WC",Flight Centre,50877.87000000001,53714.77000000001,0,,0,64020.0,13
20152,1025,2025-06-19 00:22:29,3218.68,Withdrawal,Online,"Rosebank, GP",Flight Centre,53714.77000000001,50496.09000000001,0,Odd Hours|New Location,2,37740.0,0
20153,1026,2025-05-17 03:06:25,141549.01,Transfer,ATM,"Kimberley, NC",Unknown Beneficiary,62711.8,-9567.448405322935,1,Odd Hours|New Location|Excessive Txn relative to Balance,5,,3
20154,1026,2025-05-17 03:45:25,0.0,Transfer,ATM,"Polokwane, LP",Puma Energy,-9567.448405322935,-9567.448405322935,1,Odd Hours|New Location|Excessive Txn relative to Balance,5,2340.0,3
20155,1026,2025-05-17 08:34:25,0.0,Withdrawal,Online,"Polokwane, LP",Puma Energy,-9567.448405322935,-9567.448405322935,1,Excessive Txn relative to Balance,3,17340.0,8
20156,1026,2025-05-17 21:47:25,0.0,Withdrawal,ATM,"Gqeberha, EC",Game,-9567.448405322935,-9567.448405322935,1,New Location|Excessive Txn relative to Balance,4,47580.0,21
20157,1026,2025-05-18 00:55:25,0.0,Transfer,App,"Rosebank, GP",Standard Bank ATM,-9567.448405322935,-9567.448405322935,1,Odd Hours|New Location|Excessive Txn relative to Balance,5,11280.0,0
20158,1026,2025-05-18 09:54:25,2074.51,Purchase,App,"Mbombela, MP",Woolworths,-9567.448405322935,-9958.397090072804,0,New Location,1,32340.0,9
20159,1026,2025-05-18 21:42:25,170.93,Fare,Online,"Gqeberha, EC",Takealot,-9958.397090072804,-9998.644195661564,0,,0,42480.0,21
20160,1026,2025-05-19 10:27:25,0.0,Transfer,App,"Mbombela, MP",Clicks,-9998.644195661564,-9998.644195661564,1,Excessive Txn relative to Balance,3,45900.0,10
20161,1027,2025-05-11 08:30:58,3912.4,Deposit,Online,"Rosebank, GP",Clicks,30991.33,34903.73,0,New Location,1,,8
20162,1027,2025-05-11 14:09:58,2197.92,Withdrawal,ATM,"Potchefstroom, NW",Takealot,34903.73,32705.810000000005,0,New Location,1,20340.0,14
20163,1027,2025-05-12 01:56:58,2559.47,Transfer,POS,"Mowbray, WC",Game,32705.810000000005,30146.340000000004,0,Odd Hours|New Location,2,42420.0,1
20164,1027,2025-05-12 08:38:58,334.82,Deposit,ATM,"Umhlanga, KZN",KFC,30146.340000000004,30481.160000000003,0,New Location,1,24120.0,8
20165,1028,2025-06-09 14:20:16,2889.18,Transfer,ATM,"Potchefstroom, NW",Shoprite,53597.81,50708.63,0,New Location,1,,14
20166,1028,2025-06-10 05:41:16,3646.33,Deposit,ATM,"Rosebank, GP",Puma Energy,50708.63,54354.96,0,New Location,1,55260.0,5
20167,1028,2025-06-10 20:47:16,4348.84,Deposit,ATM,"Mowbray, WC",Shoprite,54354.96,58703.8,0,New Location,1,54360.0,20
20168,1028,2025-06-11 18:49:16,1600.18,Purchase,POS,"Potchefstroom, NW",KFC,58703.8,57103.62,0,,0,79320.0,18
20169,1028,2025-06-12 06:45:16,3883.05,Withdrawal,App,"Mowbray, WC",Standard Bank ATM,57103.62,53220.57,0,,0,42960.0,6
20170,1029,2025-06-23 02:28:50,3898.86,Fare,POS,"Kimberley, NC",Standard Bank ATM,90951.79,87052.93,0,Odd Hours|New Location,2,,2
20171,1029,2025-06-23 23:26:50,4658.47,Deposit,ATM,"Gqeberha, EC",Clicks,87052.93,91711.4,0,New Location,1,75480.0,23
20172,1029,2025-06-24 19:39:50,1429.66,Fare,Online,"Kimberley, NC",Clicks,91711.4,90281.74,0,,0,72780.0,19
20173,1029,2025-06-25 03:44:50,409.34,Fare,App,"Mbombela, MP",Game,90281.74,89872.4,0,Odd Hours|New Location,2,29100.0,3
20174,1029,2025-06-25 11:43:50,3958.69,Withdrawal,App,"Umhlanga, KZN",Game,89872.4,85913.70999999999,0,New Location,1,28740.0,11
20175,1029,2025-06-25 15:15:50,3963.76,Transfer,ATM,"Polokwane, LP",Woolworths,85913.70999999999,81949.95,0,New Location,1,12720.0,15
20176,1029,2025-06-25 16:59:50,2597.98,Deposit,ATM,"Gqeberha, EC",Takealot,81949.95,84547.93,0,,0,6240.0,16
20177,1029,2025-06-26 00:40:50,4293.42,Transfer,POS,"Gqeberha, EC",Shoprite,84547.93,80254.51,0,Odd Hours,1,27660.0,0
20178,1030,2025-05-19 21:56:41,2592.3,Withdrawal,POS,"Umhlanga, KZN",FNB ATM,30319.39,27727.09,0,New Location,1,,21
20179,1030,2025-05-20 10:45:41,3216.48,Transfer,App,"Rosebank, GP",Puma Energy,27727.09,24510.61,0,New Location,1,46140.0,10
20180,1030,2025-05-20 11:28:41,1638.87,Deposit,ATM,"Potchefstroom, NW",Game,24510.61,26149.48,0,New Location,1,2580.0,11
20181,1030,2025-05-21 05:45:41,3573.03,Withdrawal,POS,"Kimberley, NC",Game,26149.48,22576.45,0,New Location,1,65820.0,5
20182,1030,2025-05-22 04:03:41,2934.81,Transfer,App,"Kimberley, NC",KFC,22576.45,19641.64,0,,0,80280.0,4
20183,1030,2025-05-22 11:31:41,3202.87,Purchase,ATM,"Mowbray, WC",Standard Bank ATM,19641.64,16438.77,0,New Location,1,26880.0,11
20184,1030,2025-05-22 15:58:41,4048.66,Deposit,POS,"Umhlanga, KZN",Woolworths,16438.77,20487.43,0,,0,16020.0,15
20185,1030,2025-05-23 13:00:41,4767.03,Deposit,POS,"Gqeberha, EC",Clicks,20487.43,25254.46,0,New Location,1,75720.0,13
20186,1030,2025-05-23 18:02:41,3090.7,Transfer,App,"Umhlanga, KZN",Clicks,25254.46,22163.76,0,,0,18120.0,18
20187,1030,2025-05-23 22:40:41,3215.74,Fare,POS,"Gqeberha, EC",Gautrain,22163.76,18948.02,0,,0,16680.0,22
20188,1031,2025-05-14 04:37:49,3262.18,Fare,App,"Mowbray, WC",Shoprite,45796.67,42534.49,0,New Location,1,,4
20189,1031,2025-05-14 10:45:49,606.0,Transfer,ATM,"Mbombela, MP",Game,42534.49,41928.49,0,New Location,1,22080.0,10
20190,1031,2025-05-15 00:02:49,2823.31,Withdrawal,Online,"Umhlanga, KZN",Shoprite,41928.49,39105.18,0,Odd Hours|New Location,2,47820.0,0
20191,1031,2025-05-15 01:02:49,4699.11,Fare,App,"Mbombela, MP",Flight Centre,39105.18,34406.07,0,Odd Hours,1,3600.0,1
20192,1031,2025-05-15 22:31:49,4054.46,Purchase,POS,"Mowbray, WC",Gautrain,34406.07,30351.61,0,,0,77340.0,22
20193,1031,2025-05-16 13:37:49,2631.31,Transfer,ATM,"Mowbray, WC",Clicks,30351.61,27720.3,0,,0,54360.0,13
20194,1031,2025-05-17 05:52:49,3490.43,Deposit,ATM,"Gqeberha, EC",Woolworths,27720.3,31210.73,0,New Location,1,58500.0,5
20195,1031,2025-05-17 19:34:49,4836.43,Transfer,App,"Umhlanga, KZN",Gautrain,31210.73,26374.3,0,,0,49320.0,19
20196,1032,2025-05-19 12:53:20,123.33,Withdrawal,App,"Potchefstroom, NW",Shoprite,82281.25,82157.92,0,New Location,1,,12
20197,1032,2025-05-19 17:26:20,3592.28,Withdrawal,App,"Kimberley, NC",FNB ATM,82157.92,78565.64,0,New Location,1,16380.0,17
20198,1032,2025-05-20 10:04:20,3219.16,Purchase,App,"Polokwane, LP",Woolworths,78565.64,75346.48,0,New Location,1,59880.0,10
20199,1032,2025-05-20 23:52:20,545.2,Fare,Online,"Mowbray, WC",Clicks,75346.48,74801.28,0,New Location,1,49680.0,23
20200,1032,2025-05-21 20:16:20,1163.37,Deposit,Online,"Gqeberha, EC",Clicks,74801.28,75964.65,0,New Location,1,73440.0,20
20201,1033,2025-05-24 11:24:25,3353.99,Transfer,ATM,"Polokwane, LP",Gautrain,55751.84,52397.85,0,New Location,1,,11
20202,1033,2025-05-24 19:04:25,3792.84,Fare,Online,"Potchefstroom, NW",Woolworths,52397.85,48605.01,0,New Location,1,27600.0,19
20203,1033,2025-05-25 05:00:25,3986.55,Transfer,POS,"Mbombela, MP",Flight Centre,48605.01,44618.45999999999,0,New Location,1,35760.0,5
20204,1033,2025-05-25 07:34:25,2939.82,Purchase,Online,"Rosebank, GP",KFC,44618.45999999999,41678.63999999999,0,New Location,1,9240.0,7
20205,1033,2025-05-25 18:12:25,326.32,Withdrawal,POS,"Mowbray, WC",Standard Bank ATM,41678.63999999999,41352.31999999999,0,New Location,1,38280.0,18
20206,1034,2025-05-22 12:05:54,4952.96,Transfer,POS,"Kimberley, NC",Puma Energy,15142.27,10189.31,0,New Location,1,,12
20207,1034,2025-05-23 03:49:54,4382.77,Withdrawal,POS,"Gqeberha, EC",Game,10189.31,5806.540000000001,0,Odd Hours|New Location,2,56640.0,3
20208,1034,2025-05-23 14:42:54,3883.84,Withdrawal,Online,"Rosebank, GP",Shoprite,5806.540000000001,1922.7000000000007,0,New Location,1,39180.0,14
20209,1034,2025-05-23 17:12:54,1634.2,Deposit,ATM,"Potchefstroom, NW",FNB ATM,1922.7000000000007,3556.9000000000005,0,New Location,1,9000.0,17
20210,1034,2025-05-24 06:25:54,1135.4,Purchase,ATM,"Gqeberha, EC",Clicks,3556.9000000000005,2421.5000000000005,0,,0,47580.0,6
20211,1034,2025-05-24 22:37:54,1761.88,Transfer,App,"Mowbray, WC",Takealot,2421.5000000000005,659.6200000000003,0,New Location,1,58320.0,22
20212,1034,2025-05-25 17:19:54,3006.35,Fare,App,"Potchefstroom, NW",Game,659.6200000000003,-2346.73,0,,0,67320.0,17
20213,1034,2025-05-26 03:20:54,0.0,Withdrawal,POS,"Mbombela, MP",Clicks,-2346.73,-2346.73,1,Odd Hours|New Location|Excessive Txn relative to Balance,5,36060.0,3
20214,1034,2025-05-26 16:26:54,0.0,Transfer,ATM,"Mbombela, MP",Clicks,-2346.73,-2346.73,1,Excessive Txn relative to Balance,3,47160.0,16
20215,1034,2025-05-26 18:23:54,2005.49,Fare,Online,"Mowbray, WC",Puma Energy,-2346.73,-4352.219999999999,0,,0,7020.0,18
20216,1035,2025-05-12 11:30:55,2127.75,Purchase,App,"Potchefstroom, NW",Shoprite,71357.41,69229.66,0,New Location,1,,11
20217,1035,2025-05-12 19:40:55,1128.63,Fare,ATM,"Gqeberha, EC",Puma Energy,69229.66,68101.03,0,New Location,1,29400.0,19
20218,1035,2025-05-13 15:48:55,4323.85,Fare,App,"Kimberley, NC",Gautrain,68101.03,63777.18,0,New Location,1,72480.0,15
20219,1035,2025-05-13 20:36:55,3268.07,Withdrawal,ATM,"Polokwane, LP",FNB ATM,63777.18,60509.11,0,New Location,1,17280.0,20
20220,1035,2025-05-13 22:26:55,3737.87,Withdrawal,POS,"Umhlanga, KZN",Takealot,60509.11,56771.24,0,New Location,1,6600.0,22
20221,1035,2025-05-14 20:10:55,4598.57,Fare,App,"Umhlanga, KZN",Game,56771.24,52172.67,0,,0,78240.0,20
20222,1035,2025-05-15 19:43:55,4348.74,Purchase,Online,"Rosebank, GP",Puma Energy,52172.67,47823.93,0,New Location,1,84780.0,19
20223,1035,2025-05-15 21:40:55,2661.67,Deposit,ATM,"Kimberley, NC",Game,47823.93,50485.6,0,,0,7020.0,21
20224,1035,2025-05-16 11:11:55,3267.34,Purchase,Online,"Gqeberha, EC",KFC,50485.6,47218.26,0,,0,48660.0,11
20225,1036,2025-06-07 20:41:43,942.88,Deposit,Online,"Kimberley, NC",Takealot,49765.39,50708.27,0,New Location,1,,20
20226,1036,2025-06-08 16:00:43,3756.51,Deposit,POS,"Polokwane, LP",Puma Energy,50708.27,54464.78,0,New Location,1,69540.0,16
20227,1036,2025-06-09 05:32:43,174.56,Withdrawal,ATM,"Rosebank, GP",Gautrain,54464.78,54290.22,0,New Location,1,48720.0,5
20228,1036,2025-06-09 19:23:43,4005.88,Fare,ATM,"Polokwane, LP",Standard Bank ATM,54290.22,50284.34,0,,0,49860.0,19
20229,1036,2025-06-10 05:02:43,3209.24,Purchase,POS,"Rosebank, GP",Woolworths,50284.34,47075.100000000006,0,,0,34740.0,5
20230,1036,2025-06-10 16:27:43,4413.35,Purchase,ATM,"Umhlanga, KZN",Flight Centre,47075.100000000006,42661.75000000001,0,New Location,1,41100.0,16
20231,1037,2025-06-21 08:49:24,3565.63,Purchase,Online,"Mowbray, WC",KFC,85649.37,82083.73999999999,0,New Location,1,,8
20232,1037,2025-06-22 04:57:24,1311.09,Transfer,Online,"Gqeberha, EC",Flight Centre,82083.73999999999,80772.65,0,New Location,1,72480.0,4
20233,1037,2025-06-23 02:57:24,2604.96,Transfer,Online,"Rosebank, GP",Clicks,80772.65,78167.68999999999,0,Odd Hours|New Location,2,79200.0,2
20234,1037,2025-06-23 08:52:24,704.5,Purchase,App,"Rosebank, GP",Clicks,78167.68999999999,77463.18999999999,0,,0,21300.0,8
20235,1037,2025-06-23 17:44:24,1468.3,Purchase,App,"Potchefstroom, NW",KFC,77463.18999999999,75994.88999999998,0,New Location,1,31920.0,17
20236,1037,2025-06-24 16:21:24,1686.97,Purchase,Online,"Polokwane, LP",Gautrain,75994.88999999998,74307.91999999998,0,New Location,1,81420.0,16
20237,1037,2025-06-25 14:45:24,2750.25,Withdrawal,Online,"Kimberley, NC",Woolworths,74307.91999999998,71557.66999999998,0,New Location,1,80640.0,14
20238,1038,2025-07-04 22:05:10,275.8,Fare,Online,"Mbombela, MP",Clicks,43368.87,43093.07,0,New Location,1,,22
20239,1038,2025-07-05 11:11:10,3436.19,Deposit,Online,"Kimberley, NC",Shoprite,43093.07,46529.26,0,New Location,1,47160.0,11
20240,1038,2025-07-05 12:17:10,3049.32,Purchase,App,"Polokwane, LP",FNB ATM,46529.26,43479.94,0,New Location,1,3960.0,12
20241,1038,2025-07-05 23:11:10,2923.91,Fare,App,"Kimberley, NC",Puma Energy,43479.94,40556.03,0,,0,39240.0,23
20242,1038,2025-07-06 01:39:10,3776.17,Withdrawal,Online,"Polokwane, LP",Woolworths,40556.03,36779.86,0,Odd Hours,1,8880.0,1
20243,1038,2025-07-06 03:28:10,1574.24,Withdrawal,Online,"Mbombela, MP",FNB ATM,36779.86,35205.62,0,Odd Hours,1,6540.0,3
20244,1039,2025-06-25 14:36:38,3029.59,Withdrawal,App,"Polokwane, LP",FNB ATM,44340.41,41310.82000000001,0,New Location,1,,14
20245,1039,2025-06-25 22:42:38,3220.86,Transfer,ATM,"Mbombela, MP",Game,41310.82000000001,38089.96000000001,0,New Location,1,29160.0,22
20246,1039,2025-06-26 04:51:38,3991.27,Transfer,Online,"Rosebank, GP",Flight Centre,38089.96000000001,34098.69000000001,0,New Location,1,22140.0,4
20247,1039,2025-06-26 09:11:38,3123.58,Withdrawal,Online,"Mbombela, MP",Woolworths,34098.69000000001,30975.110000000008,0,,0,15600.0,9
20248,1040,2025-06-04 23:42:34,1681.04,Transfer,Online,"Mowbray, WC",Clicks,54815.26,53134.22,0,New Location,1,,23
20249,1040,2025-06-05 10:08:34,2996.45,Deposit,POS,"Mowbray, WC",Puma Energy,53134.22,56130.67,0,,0,37560.0,10
20250,1040,2025-06-05 21:55:34,619.81,Transfer,App,"Rosebank, GP",Woolworths,56130.67,55510.86,0,New Location,1,42420.0,21
20251,1040,2025-06-06 13:30:34,4378.21,Withdrawal,Online,"Rosebank, GP",Gautrain,55510.86,51132.65,0,,0,56100.0,13
20252,1040,2025-06-07 01:04:34,2028.1,Purchase,POS,"Mbombela, MP",Flight Centre,51132.65,49104.55,0,Odd Hours|New Location,2,41640.0,1
20253,1040,2025-06-07 14:23:34,4202.65,Fare,App,"Gqeberha, EC",Game,49104.55,44901.9,0,New Location,1,47940.0,14
20256,1040,2025-06-07 20:45:34,3445.16,Purchase,Online,"Potchefstroom, NW",Clicks,44901.9,40655.380000000005,1,Rapid Fire|New Location,3,22920.0,20
20254,1040,2025-06-07 20:46:04,411.99,Purchase,POS,"Polokwane, LP",Woolworths,44901.9,44489.91,1,Rapid Fire|New Location,3,30.0,20
20255,1040,2025-06-07 20:46:21,389.37,Purchase,Online,"Kimberley, NC",Puma Energy,44901.9,44100.54,1,Rapid Fire|New Location,3,17.0,20
20257,1040,2025-06-08 15:10:21,1640.17,Withdrawal,Online,"Rosebank, GP",Woolworths,40655.380000000005,39015.21000000001,0,,0,66240.0,15
20258,1040,2025-06-09 12:35:21,3208.93,Deposit,App,"Mowbray, WC",Takealot,39015.21000000001,42224.14000000001,0,,0,77100.0,12
20259,1041,2025-06-24 21:57:47,84.22,Transfer,Online,"Umhlanga, KZN",Shoprite,1208.51,1124.29,0,New Location,1,,21
20260,1041,2025-06-25 17:27:47,1863.58,Deposit,App,"Kimberley, NC",Flight Centre,1124.29,2987.87,0,New Location,1,70200.0,17
20261,1041,2025-06-26 04:30:47,181.1,Fare,App,"Polokwane, LP",Gautrain,2987.87,2806.77,0,New Location,1,39780.0,4
20262,1041,2025-06-26 06:20:47,4629.22,Fare,App,"Rosebank, GP",Clicks,2806.77,-1822.4500000000005,0,New Location,1,6600.0,6
20263,1041,2025-06-26 13:22:47,1917.24,Purchase,ATM,"Rosebank, GP",Takealot,-1822.4500000000005,-3739.690000000001,0,,0,25320.0,13
20264,1041,2025-06-27 02:00:47,0.0,Withdrawal,App,"Kimberley, NC",Flight Centre,-3739.690000000001,-3739.690000000001,1,Odd Hours|Excessive Txn relative to Balance,4,45480.0,2
20265,1041,2025-06-27 12:05:47,2297.65,Fare,POS,"Umhlanga, KZN",Standard Bank ATM,-3739.690000000001,-6037.34,0,,0,36300.0,12
20266,1041,2025-06-27 15:01:47,3136.74,Fare,Online,"Gqeberha, EC",FNB ATM,-6037.34,-9174.08,0,New Location,1,10560.0,15
20267,1042,2025-05-13 17:37:00,1811.18,Purchase,ATM,"Umhlanga, KZN",Clicks,86401.07,84589.89000000001,0,New Location,1,,17
20268,1042,2025-05-14 14:36:00,4432.85,Withdrawal,App,"Mbombela, MP",Standard Bank ATM,84589.89000000001,80157.04000000001,0,New Location,1,75540.0,14
20269,1042,2025-05-15 04:12:00,4791.64,Purchase,App,"Kimberley, NC",Puma Energy,80157.04000000001,75365.40000000001,0,New Location,1,48960.0,4
20270,1042,2025-05-15 16:41:00,1887.9,Transfer,POS,"Rosebank, GP",FNB ATM,75365.40000000001,73477.50000000001,0,New Location,1,44940.0,16
20271,1042,2025-05-16 01:13:00,4834.29,Purchase,POS,"Kimberley, NC",KFC,73477.50000000001,68643.21000000002,0,Odd Hours,1,30720.0,1
20272,1043,2025-06-09 07:14:35,4350.88,Withdrawal,POS,"Mbombela, MP",Flight Centre,70703.54,66352.65999999999,0,New Location,1,,7
20273,1043,2025-06-09 18:03:35,167.84,Purchase,POS,"Mbombela, MP",Takealot,66352.65999999999,66184.81999999999,0,,0,38940.0,18
20274,1043,2025-06-10 04:55:35,4087.33,Fare,ATM,"Gqeberha, EC",Shoprite,66184.81999999999,62097.48999999999,0,New Location,1,39120.0,4
20275,1044,2025-06-12 20:39:24,483.4,Transfer,POS,"Rosebank, GP",Gautrain,60617.53,60134.13,0,New Location,1,,20
20276,1044,2025-06-13 14:28:24,2135.98,Withdrawal,Online,"Polokwane, LP",KFC,60134.13,57998.15,0,New Location,1,64140.0,14
20277,1044,2025-06-14 03:47:24,1004.69,Transfer,ATM,"Potchefstroom, NW",Game,57998.15,56993.45999999999,0,Odd Hours|New Location,2,47940.0,3
20278,1044,2025-06-14 23:03:24,904.53,Withdrawal,App,"Polokwane, LP",Woolworths,56993.45999999999,56088.92999999999,0,,0,69360.0,23
20279,1044,2025-06-15 11:40:24,3988.35,Transfer,App,"Potchefstroom, NW",FNB ATM,56088.92999999999,52100.58,0,,0,45420.0,11
20280,1044,2025-06-15 22:46:24,3309.14,Deposit,App,"Potchefstroom, NW",Standard Bank ATM,52100.58,55409.72,0,,0,39960.0,22
20281,1045,2025-06-29 16:34:42,3940.09,Purchase,POS,"Gqeberha, EC",Game,56936.78,52996.69,0,New Location,1,,16
20282,1045,2025-06-30 13:28:42,1169.17,Fare,Online,"Polokwane, LP",Shoprite,52996.69,51827.52,0,New Location,1,75240.0,13
20283,1045,2025-06-30 17:12:42,784.28,Transfer,Online,"Umhlanga, KZN",Takealot,51827.52,51043.240000000005,0,New Location,1,13440.0,17
20284,1045,2025-06-30 19:43:42,640.83,Transfer,POS,"Mowbray, WC",Shoprite,51043.240000000005,50402.41,0,New Location,1,9060.0,19
20285,1045,2025-07-01 04:35:42,1147.89,Transfer,App,"Polokwane, LP",Gautrain,50402.41,49254.52,0,,0,31920.0,4
20286,1045,2025-07-01 12:22:42,3327.5,Fare,App,"Polokwane, LP",Clicks,49254.52,45927.02,0,,0,28020.0,12
20287,1045,2025-07-02 01:31:42,3335.73,Withdrawal,Online,"Polokwane, LP",KFC,45927.02,42591.29,0,Odd Hours,1,47340.0,1
20288,1046,2025-06-26 07:54:47,2526.55,Purchase,POS,"Gqeberha, EC",Takealot,4444.57,1918.0199999999995,0,New Location,1,,7
20289,1046,2025-06-26 22:49:47,3963.26,Deposit,App,"Rosebank, GP",Shoprite,1918.0199999999995,5881.28,0,New Location,1,53700.0,22
20290,1046,2025-06-27 16:51:47,3903.24,Transfer,POS,"Potchefstroom, NW",KFC,5881.28,1978.04,0,New Location,1,64920.0,16
20291,1047,2025-05-30 04:30:23,2088.01,Fare,App,"Rosebank, GP",Clicks,28438.39,26350.38,0,New Location,1,,4
20292,1047,2025-05-30 07:13:23,3430.66,Withdrawal,ATM,"Kimberley, NC",Puma Energy,26350.38,22919.72,0,New Location,1,9780.0,7
20293,1047,2025-05-30 07:19:23,2694.81,Withdrawal,App,"Kimberley, NC",Clicks,22919.72,20224.91,0,,0,360.0,7
20294,1047,2025-05-30 08:27:23,2165.76,Purchase,ATM,"Umhlanga, KZN",Game,20224.91,18059.149999999998,0,New Location,1,4080.0,8
20295,1047,2025-05-31 01:53:23,3596.46,Fare,Online,"Umhlanga, KZN",Standard Bank ATM,18059.149999999998,14462.689999999997,0,Odd Hours,1,62760.0,1
20296,1047,2025-05-31 02:27:23,217.22,Purchase,Online,"Kimberley, NC",Takealot,14462.689999999997,14245.469999999996,0,Odd Hours,1,2040.0,2
20297,1047,2025-05-31 02:59:23,3114.86,Deposit,App,"Polokwane, LP",Flight Centre,14245.469999999996,17360.329999999994,0,Odd Hours|New Location,2,1920.0,2
20298,1047,2025-05-31 08:02:23,3152.93,Purchase,POS,"Umhlanga, KZN",FNB ATM,17360.329999999994,14207.399999999994,0,,0,18180.0,8
20299,1047,2025-06-01 04:54:23,910.39,Transfer,Online,"Rosebank, GP",Standard Bank ATM,14207.399999999994,13297.009999999997,0,,0,75120.0,4
20300,1047,2025-06-01 13:08:23,3138.65,Purchase,Online,"Gqeberha, EC",Game,13297.009999999997,10158.359999999995,0,New Location,1,29640.0,13
20301,1048,2025-07-08 02:18:39,2932.23,Transfer,Online,"Umhlanga, KZN",Clicks,54831.82,51899.59,0,Odd Hours|New Location,2,,2
20302,1048,2025-07-08 14:00:39,3529.53,Deposit,Online,"Kimberley, NC",Standard Bank ATM,51899.59,55429.12,0,New Location,1,42120.0,14
20303,1048,2025-07-09 10:11:39,3054.38,Purchase,Online,"Kimberley, NC",Game,55429.12,52374.74,0,,0,72660.0,10
20304,1048,2025-07-09 22:50:39,4413.82,Fare,App,"Mowbray, WC",KFC,52374.74,47960.92,0,New Location,1,45540.0,22
20305,1048,2025-07-10 02:58:39,2386.6,Transfer,Online,"Polokwane, LP",Flight Centre,47960.92,45574.32,0,Odd Hours|New Location,2,14880.0,2
20306,1048,2025-07-10 10:07:39,4904.14,Deposit,ATM,"Umhlanga, KZN",Game,45574.32,50478.46,0,,0,25740.0,10
20307,1048,2025-07-11 08:35:39,2766.36,Deposit,Online,"Mbombela, MP",Standard Bank ATM,50478.46,53244.82,0,New Location,1,80880.0,8
20308,1048,2025-07-11 08:44:39,255.02,Transfer,ATM,"Mowbray, WC",Woolworths,53244.82,52989.8,0,,0,540.0,8
20309,1048,2025-07-11 21:20:39,948.79,Withdrawal,Online,"Mowbray, WC",Gautrain,52989.8,52041.01,0,,0,45360.0,21
20310,1049,2025-06-30 08:33:20,2709.0,Fare,Online,"Potchefstroom, NW",FNB ATM,92695.85,89986.85,0,New Location,1,,8
20311,1049,2025-06-30 14:51:20,2992.83,Deposit,POS,"Mowbray, WC",Takealot,89986.85,92979.68,0,New Location,1,22680.0,14
20312,1049,2025-07-01 09:48:20,2198.2,Fare,App,"Mowbray, WC",Gautrain,92979.68,90781.48,0,,0,68220.0,9
20313,1049,2025-07-02 07:03:20,1532.62,Purchase,POS,"Umhlanga, KZN",Shoprite,90781.48,89248.86000000002,0,New Location,1,76500.0,7
20314,1049,2025-07-03 05:04:20,3597.62,Transfer,POS,"Umhlanga, KZN",Gautrain,89248.86000000002,85651.24000000002,0,,0,79260.0,5
20315,1049,2025-07-03 18:13:20,2579.59,Fare,Online,"Kimberley, NC",Flight Centre,85651.24000000002,83071.65000000002,0,New Location,1,47340.0,18
20316,1049,2025-07-04 16:06:20,3522.21,Withdrawal,ATM,"Gqeberha, EC",KFC,83071.65000000002,79549.44000000002,0,New Location,1,78780.0,16
20317,1049,2025-07-04 21:42:20,2651.28,Deposit,POS,"Kimberley, NC",Flight Centre,79549.44000000002,82200.72000000002,0,,0,20160.0,21
20318,1049,2025-07-05 05:56:20,2188.47,Purchase,App,"Rosebank, GP",Clicks,82200.72000000002,80012.25000000001,0,New Location,1,29640.0,5
20319,1050,2025-07-03 22:43:38,3048.77,Transfer,ATM,"Mowbray, WC",Shoprite,99959.01,96910.24,0,New Location,1,,22
20320,1050,2025-07-04 12:54:38,4113.43,Transfer,App,"Rosebank, GP",FNB ATM,96910.24,92796.81,0,New Location,1,51060.0,12
20321,1050,2025-07-05 10:30:38,4404.31,Transfer,Online,"Umhlanga, KZN",Gautrain,92796.81,88392.5,0,New Location,1,77760.0,10
20322,1050,2025-07-06 10:23:38,384.77,Fare,ATM,"Kimberley, NC",Flight Centre,88392.5,88007.73,0,New Location,1,85980.0,10
20323,1050,2025-07-07 09:23:38,4068.77,Transfer,POS,"Potchefstroom, NW",Gautrain,88007.73,83938.95999999999,0,New Location,1,82800.0,9
20324,1050,2025-07-07 13:04:38,1621.9,Transfer,ATM,"Mowbray, WC",Standard Bank ATM,83938.95999999999,82317.06,0,,0,13260.0,13
20325,1050,2025-07-07 14:49:38,2614.76,Withdrawal,App,"Gqeberha, EC",FNB ATM,82317.06,79702.3,0,New Location,1,6300.0,14
20326,1050,2025-07-07 20:13:38,1829.76,Purchase,POS,"Polokwane, LP",FNB ATM,79702.3,77872.54000000001,0,New Location,1,19440.0,20
20327,1050,2025-07-08 08:17:38,1228.66,Withdrawal,ATM,"Mowbray, WC",Woolworths,77872.54000000001,76643.88,0,,0,43440.0,8
20328,1050,2025-07-09 07:10:38,370.61,Fare,ATM,"Rosebank, GP",Puma Energy,76643.88,76273.27,0,,0,82380.0,7
